{
    "tileSize": 16,

    "shiftTarget": "player",

    "BGData": {
        "shiftType": "xy",
        "shiftTarget": "player"
    },

    "playerData": {
        "size": {"width":0.95, "height":0.95},
        "color": "rgba(240,0,0,1)",
        "position":
        [
            "................",
            ".@..............",
            "................",
            "................",
            "................",
            "................",
            "................",
            "................",
            "................",
            "................",
            "................",
            "................",
            "................",
            "................",
            "................",
            "................"
        ]
    },

    "endBlockData": {
        "toLevel": 3,
        "position":
        [
            "................",
            "................",
            "................",
            "................",
            "................",
            "................",
            "................",
            "................",
            "................",
            "................",
            "................",
            "................",
            "................",
            "................",
            "..............#.",
            "................"
        ]
    },

    "wallData": {
        "shiftTarget": "player",
        "staticMono":
        [
            "1111111111111111",
            "1....1.1.1.1.1.1",
            "1..2.4.6...7...1",
            "1122.1.1.1.1.1.1",
            "1....4.6.7.1.c.1",
            "14.144...1.8.1.1",
            "1......6.6.1.c.1",
            "11414166.1.1.1.1",
            "1........8.8.c.1",
            "1111618188.1.1.1",
            "1..........a.c.1",
            "118118.181aa.1.1",
            "1............c.1",
            "11c11c.11111cc.1",
            "1.......d......1",
            "1111111111111111"
        ],

        "dynamicMono":
        [
            "................",
            "................",
            "................",
            "................",
            "................",
            "................",
            "................",
            "................",
            "................",
            "................",
            "................",
            "................",
            "................",
            "................",
            "................",
            "................"
        ]
    }
}