{
    "tileSize": 16,
    "shiftTarget": "player",

    "BGData":
    {
        "shiftType": "x"
    },

    "playerData": {
        "size": {"width":0.95, "height":0.95},
        "color": "rgba(240,0,0,1)",
        "position":
        [
            "................",
            ".@..............",
            "................",
            "................",
            "................",
            "................",
            "................",
            "................",
            "................",
            "................",
            "................",
            "................",
            "................",
            "................",
            "................",
            "................"
        ]
    },

    "endBlockData": {
        "toLevel": 2,
        "position":
        [
            "................",
            "................",
            "................",
            "................",
            "................",
            "................",
            "................",
            "................",
            "................",
            "................",
            "................",
            "................",
            "................",
            "................",
            "..............#.",
            "................"
        ]
    },

    "wallData": 
    {
        "staticMono":
        [
            "1111111111111111",
            "1..............1",
            "1..............1",
            "1..............1",
            "1..............1",
            "1..............1",
            "1..............1",
            "1..............1",
            "1..............1",
            "1..............1",
            "1..............1",
            "1..............1",
            "1..............1",
            "1..............1",
            "1..............1",
            "1111111111111111"
        ],

        "dynamicMono":
        [
            "................",
            "................",
            "................",
            "................",
            "................",
            "................",
            "................",
            "................",
            "................",
            "................",
            "................",
            "................",
            "................",
            "................",
            "................",
            "................"
        ]
    }
}