{
    "tileSize": 16,
    "levelLayout": 
        {
            "player":
                [
                    "................",
                    ".@..............",
                    "................",
                    "................",
                    "................",
                    "................",
                    "................",
                    "................",
                    "................",
                    "................",
                    "................",
                    "................",
                    "................",
                    "................",
                    "................",
                    "................"
                ],
            "monoWalls":
                [
                    "123456789....",
                    "1...............",
                    "1...............",
                    "0...............",
                    "1...4...........",
                    "1...4...........",
                    "1...4...........",
                    "1...4...........",
                    "1...4...........",
                    "1...4...........",
                    "1...4...........",
                    "1...4...........",
                    "1...4...........",
                    "1...2...........",
                    "1...3...........",
                    "111122228888...."
                ],
            "monoXWalls":
                [
                    "................",
                    "................",
                    "................",
                    "................",
                    "................",
                    "................",
                    "................",
                    "................",
                    "................",
                    "................",
                    "................",
                    "................",
                    "................",
                    "................",
                    "................",
                    "................"
                ],
                "monoYWalls":
                [
                    "................",
                    "................",
                    "................",
                    "................",
                    "................",
                    "................",
                    "................",
                    "................",
                    "................",
                    "................",
                    "................",
                    "................",
                    "................",
                    "................",
                    "................",
                    "................"
                ]
        }
}